TILEMAP
16 16 							-- Size of tile map in tiles
32 32 							-- Tile size & block size
images/repaired_sheet.png 				-- Tilesheet
16 16 							-- Number of tiles in tilesheet
72 72 72 72 72 72 72 72 72 73 72 72 72 72 72 72
72 72 72 72 72 72 0 56 72 72 57 72 89 72 72 72
72 72 72 72 72 72 0 0 57 0 0 56 0 72 72 72
72 72 72 72 72 0 0 0 0 0 0 0 0 0 72 72
72 0 72 72 72 3 2 0 0 0 0 0 0 0 0 72
0 0 0 72 72 72 72 0 0 0 0 0 0 0 0 0
0 0 0 0 72 72 72 0 0 0 0 0 0 0 0 8
0 0 0 40 72 72 72 72 72 72 72 41 0 0 0 24
0 0 0 72 72 72 72 72 72 72 72 72 72 41 72 72
0 0 40 72 73 72 89 57 0 0 56 72 73 72 72 72
0 0 56 72 72 72 72 0 0 0 0 72 89 72 72 72
0 0 0 57 0 56 72 0 0 0 0 72 72 72 72 72
0 0 0 0 0 0 72 72 72 72 72 57 56 72 72 72
0 0 2 0 0 0 56 72 72 72 57 0 0 0 72 72
72 72 72 0 0 0 0 56 72 72 0 0 0 0 72 72
72 72 72 0 0 72 0 0 72 72 0 0 0 72 72 72