TILEMAP
16 16 							-- Size of tile map in tiles
32 32 							-- Tile size & block size
images/repaired_sheet.png 				-- Tilesheet
16 16 							-- Number of tiles in tilesheet
0 0 0 0 0 0 0 0 0 0 0 0 0 0 0 0 
72 72 72 57 0 0 0 0 72 72 57 0 0 0 0 0 
72 73 57 0 0 40 72 72 73 72 0 0 0 0 0 0 
57 0 0 0 0 0 0 0 72 72 0 0 0 0 0 0 
0 0 0 40 40 0 0 0 0 72 41 0 0 0 0 0 
41 0 40 72 72 72 0 0 72 57 0 0 0 0 0 0 
72 73 72 72 72 73 0 0 72 0 0 0 0 0 0 0 
72 72 72 72 89 72 0 0 57 0 0 0 0 0 0 0 
72 57 0 56 72 72 0 0 0 0 0 0 0 0 0 0 
56 0 0 0 72 73 0 0 0 0 0 0 0 0 0 0 
0 0 0 0 56 72 0 0 0 0 0 0 0 0 0 0 
0 0 0 0 72 72 0 0 0 0 0 0 0 0 0 0 
1 0 0 40 72 57 56 0 0 0 0 0 0 0 0 0 
0 0 0 0 57 0 0 0 0 0 0 0 0 0 0 0 
0 0 0 0 0 0 0 0 0 0 0 0 0 0 0 0 
0 0 0 0 0 0 0 0 0 0 0 0 0 0 0 0