TILEMAP
16 16 							-- Size of tile map in tiles
32 32 							-- Tile size & block size
images/repaired_sheet.png 				-- Tilesheet
16 16 							-- Number of tiles in tilesheet
35 0 0 0 0 49 50 50 50 34 36 34 34 34 34 34 
35 0 0 0 0 0 0 0 0 49 50 50 50 50 34 34 
35 0 0 0 0 0 0 0 0 0 0 0 0 0 33 36 
35 0 0 0 0 0 0 0 0 0 0 0 0 0 33 34 
35 0 0 0 0 0 0 0 0 0 0 0 0 0 33 34 
35 86 0 0 0 0 0 0 0 0 0 0 0 0 33 34 
34 19 0 0 0 0 0 0 0 0 0 0 0 0 49 50 
34 51 0 0 0 0 0 0 0 0 0 0 0 0 0 0 
51 0 0 0 0 0 0 0 0 0 0 0 0 0 0 0 
0 0 0 0 0 0 0 0 0 0 0 0 0 0 0 0 
0 0 0 0 0 0 0 0 0 0 0 0 0 0 0 0 
0 0 0 0 0 0 0 0 0 0 0 0 0 0 0 0 
0 0 0 0 0 0 0 0 0 0 0 0 0 0 0 0 
0 0 0 0 0 0 0 0 0 0 0 0 0 0 0 0 
0 0 0 0 0 0 0 0 0 0 0 0 0 0 0 0 
18 18 18 19 0 0 0 0 0 0 0 0 0 0 0 0