TILEMAP
16 16 							-- Size of tile map in tiles
32 32 							-- Tile size & block size
images/repaired_sheet.png 				-- Tilesheet
16 16 							-- Number of tiles in tilesheet
34 34 34 36 34 34 34 34 34 34 34 35 0 0 33 34 
34 34 34 34 34 36 34 34 50 50 50 51 0 0 33 34 
34 34 50 50 50 50 50 51 17 18 18 19 0 0 33 34 
34 35 17 18 19 23 17 19 49 50 50 51 0 0 33 34 
50 51 33 34 35 0 49 51 23 0 0 0 0 0 33 34 
0 0 49 50 51 0 0 0 0 0 0 0 0 0 33 34 
0 0 85 85 85 0 0 0 0 0 0 0 0 17 34 36 
0 0 0 0 0 0 0 0 0 0 0 0 0 49 50 50 
0 0 0 0 0 0 0 0 0 0 0 0 0 0 0 0 
0 0 0 0 0 0 0 0 0 0 0 0 0 0 0 0 
0 0 0 0 0 0 0 0 0 0 0 0 0 0 0 0 
0 0 0 0 0 0 0 0 0 0 0 0 0 0 0 0 
18 18 19 0 0 0 0 0 0 0 0 0 0 0 0 0 
34 34 34 18 18 18 19 0 0 0 0 0 0 0 17 18 
34 36 34 34 34 34 35 0 0 0 17 18 18 18 34 34 
34 34 34 34 36 34 35 0 0 0 33 34 34 34 36 34