TILEMAP
16 16 							-- Size of tile map in tiles
32 32 							-- Tile size & block size
images/repaired_sheet.png 				-- Tilesheet
16 16 							-- Number of tiles in tilesheet
34 34 34 34 34 34 50 51 0 0 0 0 49 34 34 34
34 36 34 34 34 35 0 0 0 0 0 0 0 33 36 34
34 34 34 36 34 51 0 0 0 0 0 0 0 49 34 34
34 50 34 34 35 0 0 0 0 0 0 0 0 0 49 34
51 0 49 34 51 0 0 0 0 0 0 0 0 0 0 49
0 0 0 71 17 18 19 0 0 0 0 0 0 0 0 0
0 0 0 0 33 34 35 86 86 86 86 0 0 0 0 0
0 0 0 0 49 50 50 21 21 21 22 0 0 0 0 0
0 0 0 0 0 0 0 0 23 23 0 0 0 0 17 18
0 0 0 0 0 0 0 0 0 0 0 0 0 0 33 34
0 0 0 0 0 0 0 0 0 0 0 0 0 0 33 34
0 0 0 0 0 0 0 86 86 86 86 0 0 0 33 36
0 0 0 0 0 0 0 20 18 18 22 0 0 0 33 34
0 0 0 0 0 0 0 0 33 35 0 0 0 0 33 34
18 18 19 0 0 0 0 0 33 35 0 0 0 0 33 34
34 36 35 0 0 39 0 0 33 35 0 0 0 17 34 34