TILEMAP
16 16 							-- Size of tile map in tiles
32 32 							-- Tile size & block size
images/repaired_sheet.png 				-- Tilesheet
16 16 							-- Number of tiles in tilesheet
34 50 51 0 0 0 33 50 50 50 50 50 50 50 34 34
35 0 0 0 0 0 55 0 0 0 0 0 0 0 33 34
51 0 0 0 0 0 71 0 0 0 0 0 0 0 33 34
0 0 0 0 0 0 0 0 0 0 0 0 0 0 33 36
0 0 0 0 0 0 0 0 0 0 0 0 0 0 33 34
0 0 0 0 0 0 0 0 0 0 0 0 0 0 33 34
0 0 0 0 0 0 0 0 0 0 0 0 0 0 49 50
0 0 0 0 0 0 0 0 0 0 0 0 0 0 0 0
0 0 0 0 0 0 0 0 0 0 0 0 0 0 0 0
0 0 0 0 0 0 0 0 0 0 0 0 0 0 0 0
0 0 0 0 0 0 0 0 0 0 0 0 0 0 0 0
0 0 0 0 0 0 0 0 0 0 0 0 0 0 0 0
0 0 0 0 0 0 86 86 86 0 0 0 0 0 0 0
86 86 23 86 86 86 17 18 19 0 0 0 0 0 0 0
18 18 18 18 18 19 33 36 35 86 86 86 23 23 86 86
34 36 34 34 34 35 33 34 35 17 18 18 18 18 18 18