TILEMAP
16 16 							-- Size of tile map in tiles
32 32 							-- Tile size & block size
images/repaired_sheet.png 				-- Tilesheet
16 16 							-- Number of tiles in tilesheet
50 51 0 0 0 33 50 50 50 51 49 50 50 50 34 34
0 0 0 0 0 71 0 0 0 0 0 0 0 0 49 36
0 0 0 0 0 0 0 0 0 0 0 0 0 0 0 33
0 0 0 20 21 22 0 0 0 0 0 0 0 0 0 33
0 0 0 0 0 0 0 0 0 0 86 86 0 0 0 49
0 0 0 0 0 0 0 0 0 0 17 19 0 0 0 0
0 0 0 0 0 0 86 86 0 0 33 35 0 0 0 0
0 0 0 0 0 0 20 22 0 0 33 35 0 0 0 0
0 0 0 0 0 0 23 0 0 0 49 34 19 0 0 0
0 0 0 0 0 0 39 0 0 0 0 49 51 0 0 0
0 0 0 0 0 0 71 0 0 0 0 0 0 0 0 0
0 0 0 0 0 0 23 0 0 0 0 0 0 0 0 0
21 21 21 22 0 0 23 0 0 0 0 0 0 0 0 0
0 0 23 0 0 0 23 0 0 0 0 20 21 21 21 21
0 0 23 0 0 0 39 0 0 0 0 0 23 0 0 0
0 0 23 0 0 0 55 0 0 0 0 0 23 0 0 0