TILEMAP
16 16 							-- Size of tile map in tiles
32 32 							-- Tile size & block size
images/repaired_sheet.png 				-- Tilesheet
16 16 							-- Number of tiles in tilesheet
34 34 35 0 0 0 0 33 34 50 50 50 50 34 36 34 
34 36 35 0 0 0 0 49 51 0 0 0 0 49 50 34 
34 34 35 0 0 0 0 23 0 0 0 0 0 0 0 49 
34 34 35 0 0 0 0 23 0 0 0 0 0 0 0 0 
34 34 35 39 0 0 0 23 0 0 0 0 0 0 0 0 
36 34 35 71 0 0 0 0 0 0 0 0 0 0 0 0 
50 50 51 23 0 0 0 0 0 0 0 0 0 39 0 0 
21 21 21 22 86 86 0 0 0 0 0 0 86 55 0 0 
0 0 0 20 22 23 0 0 0 0 0 0 23 55 0 0 
0 0 0 0 0 0 0 0 0 0 0 0 0 71 0 0 
0 0 0 0 0 0 0 0 0 0 0 0 0 0 0 0 
0 0 0 0 0 0 0 0 0 0 0 0 0 0 0 0 
0 0 0 0 0 0 0 0 0 0 0 0 0 0 0 0 
0 0 0 0 0 0 0 0 0 0 0 0 0 0 0 0 
0 39 0 0 0 0 0 0 0 0 0 0 0 0 0 0 
0 55 0 0 0 0 0 0 0 0 0 0 0 0 0 0