TILEMAP
16 16 							              -- Size of tile map in tiles
32 32 							              -- Tile size & block size
images/repaired_sheet.png 				-- Tilesheet
16 16 							              -- Number of tiles in tilesheet
34 36 34 34 34 35 0 0 0 0 33 34 36 34 34 34 
34 34 36 34 50 51 0 0 0 0 49 50 34 34 36 34 
34 34 50 51 0 0 0 0 0 0 0 0 49 50 34 34 
36 35 0 0 0 0 0 0 0 0 0 0 0 0 33 34 
34 35 0 0 0 0 0 0 0 0 0 0 0 0 33 34 
34 51 0 0 0 0 0 86 86 0 0 0 0 0 49 36 
35 0 0 0 0 0 0 20 22 0 0 0 0 0 0 33 
35 0 0 0 0 0 0 0 0 0 0 0 0 0 0 33 
51 0 0 0 0 0 0 0 0 0 0 0 0 0 0 49 
0 0 0 0 0 0 0 0 0 0 0 0 0 0 0 0 
0 0 0 0 0 0 0 0 0 0 0 0 0 0 0 0 
0 0 0 0 0 0 0 0 0 0 0 0 0 0 0 0 
0 0 0 0 0 0 0 0 0 0 0 0 0 0 0 0 
0 0 0 0 0 0 0 0 0 0 0 0 0 0 0 0 
0 0 0 0 0 0 0 0 0 0 0 0 0 0 0 0 
0 17 18 19 0 0 0 0 0 0 0 0 0 0 0 0
